NO assets/bluestone.xpm
SO assets/purplestone.xpm       
WE assets/greystone.xpm
EA assets/wood.xpm

F 220,100,0
C 225,30,0

 11111111 11111111111111111111111111111111111111111111111
100000001110000100000000000000000000000000000000000000001
100000001110000100000000000000000000000000000000000000001
100000001110000100000000000000000000000000000000000000001
100000001110000100000000001111100000000000000000000000001
100000001110000100000000010000010000000000000000000000001
100000001110000100000000000000000000000000000000000000001
100000001110000111111111111100000000000000000000000000001
100000001110000110000000000000000000000000000000000000001
10000000111000011000N000000000000000000000000000000000001
100000001110000110000000000000000000000000000000000000001
100000001110000110000000000000000000000000000000000000001
 11111111111111111111111111111111111111111111111111111111