       NO assets/bluestone.xpm
         SO assets/greenlight.xpm       
WE assets/greystone.xpm
EA assets/wood.xpm
				F 220,100,0
C 225,30,0

111111111 11111111111111111111111111
100000001110000100000000000000000001
100000000000000100000000000000000001
100000000000000011111111111100000001
100000000000000000000000000100000001
100000000000000101001010110000000001
100000000000000100000000100100000001
100000000000000100000000000000000001
10000000000000010000000000N000000001
100000000000000100000000000000000001
111111111111111111111111111111111111